11111111
10000001
10B0C001
1P0000E1
11111111
