111111111111111111
100000000000000001
10000000000CCCCCC1
10P000000000000001
100000000000000001
100000000000000001
111111111111111111
