111111111111111111
100000000000000001
10000000000CCCCCC1
100000000000000001
1PPP00000000000001
1E0000000000000001
111111111111111111
