11111111
10000001
1000C011
1P0001E1
11111111
